49,18
W                                               W
W                                W     W        W
W                                W     W        W
W                                W     W   W    W
W        WWWWWWWWWWWWWWWWWWWWWWWWW     W   W    W
W        WWWWWWWWWWWWWWWWWWWWWWWWW     W   W    W
W              W                 W     W   W    W
W              W                       W   W    W
W              W                           W    W
WW       WWWWWWW      WW     WWWWWWWWWWWWWWW    W
WWWW                 WWWW                 WW    W
WWWWWW              WWWWWW                WW    W
WWWWWWW           WWWWWWWWW               WW    W
WWWWWWWW         WWWWWWWWWWW              WW    W
WWWWWWWWWW      WWWWWWWWWWWWW             WW    W
WWWWWWWWWW      WWWWWWWWWWWWWWWWWWWWWWWWWWWW    W
WWWWWWWWWW      WWWWWWWWWWWWWWWWWWWWWWWWWWWW    W
WWWWWWWWWWWWWWWWWWWWWWWWWWWWWWWWWWWWWWWWWWWWWWWWW