W                                      WWWWWWWWWW
W                                W     W        W
W                                W     W        W
W                                W     W    W   W
W        WWWWWWWWWWWWWWWWWWWWWWWWW     W    W   W
W        WWWWWWWWWWWWWWWWWWWWWWWWWWWWWWW    W   W
W              W                 W     W    W   W
W              W                 W     W    W   W
W              W                 W          W   W
WW       WWWWWWW      WW     WWWWWWWWWWW    W   W
WWWW                 WWWW                   W   W
WWWWWW              WWWWWW                  W   W
WWWWWWW           WWWWWWWWW                 W   W
WWWWWWWW         WWWWWWWWWWW                W   WWW
WWWWWWWWWW      WWWWWWWWWWWWW               W    
WWWWWWWWWW      WWWWWWWWWWWWWWWWWWWWWWWW    W    
WWWWWWWWWW      WWWWWWWWWWWWWWWWWWWWWWWW    W    
WWWWWWWWWWWWWWWWWWWWWWWWWWWWWWWWWWWWWWWWWWWWWWWWWWW