49,18
W                                      W    W   W
W                                W     W    W   W
W                                W     W    W   W
W                                W     W    W   W
W        WWWWWWWWWWWWWWWWWWWWWWWWW     W    W   W
W        WWWWWWWWWWWWWWWWWWWWWWWWWWWWWWW    W   W
W              W                 W     W    W   W
W              W                 W     W    W   W
W              W                 W          W   W
WW       WWWWWWW      WW     WWWWWWWWWWW    W   W
WWWW                 WWWW                   W   W
WWWWWW              WWWWWW                  W   W
WWWWWWW           WWWWWWWWW                 W   W
WWWWWWWW         WWWWWWWWWWW                W   W
WWWWWWWWWW      WWWWWWWWWWWWW               W   W
WWWWWWWWWW      WWWWWWWWWWWWWWWWWWWWWWWW    W   W
WWWWWWWWWW      WWWWWWWWWWWWWWWWWWWWWWWW    W   W
WWWWWWWWWWWWWWWWWWWWWWWWWWWWWWWWWWWWWWWWWWWWWWWWW