W                                      WWWWWWWWWW
W                                W     W        W
W                                W     W        W
W                                W     W    W   W
W        WWWWWWWWWWWWWWWWWWWWWWWWW     W    W   W
W        WWWWWWWWWWWWWWWWWWWWWWWWWWWWWWW    W   W
W              W                 W     W    W   W
W              W                 W     W    W   W
W              W                 W          W   W
WW       WWWWWWW      WW     WWWWWWWWWWW    W   W
WWWW                 WWWW                   W   W
WWWWWW              WWWWWW                  W   W
WWWWWWW           WWWWWWWWW                 W   W
WWWWWWWW         WWWWWWWWWWW                W   WWW
                WWWWWWWWWWWWW               W     W
                WWWWWWWWWWWWWWWWWWWWWWWW    W     W
                WWWWWWWWWWWWWWWWWWWWWWWW    W     W
WWWWWWWWWWWWWWWWWWWWWWWWWWWWWWWWWWWWWWWWWWWWWWWWWWW